XXXXXXXXXXXXXXXXXXXX
X                  X
X X X XIXIX X X X  X
X   IIII     I     X
X X X X X X XVX X  X
X    IIIII   I     X
X X X X X X X X XIIX
X               I IX
X X X X X X X X X IX
X               I IX
X X X X X X X X X  X
X               I IX
X X XIX X X X X X IX
X   IVI         IBIX
X X XIX X X X X XIIX
X                  X
X X X XIX X X X X  X
X      IAIP        X
XIIIIIIIIIIIIIIIIIIX
XXXXXXXXXXXXXXXXXXXX