XXXXXXXXXXXXXXXXXXXX
X                  X
X                  X
X                  X
X                  X
X                  X
X   I              X
X                  X
X                  X
X                  X
X                  X
X          V       X
X                  X
X                  X
X            A     X
X                  X
X                  X
X                  X
X                  X
XXXXXXXXXXXXXXXXXXXX